1111111111111111111111111111111111111
1000000000000000000000000000001000001
1000000000000000000000000000001000001
1000000000000000000000000000001000001
1000000000000020000000000000001000001
1000000000000000000000000000001000001
1000000000000000000000000000001000001
1000000000000000000000000000001000001
1000000000000000000000000000001000001
1000000000000000000000000000001000001
1000000000000000000000000000001000001
1000000000000000000000000000001000001
1000000000000000000000000000001000001
1000000000000000000000000000001000001
1000000000000000000000000000001000001
1000000000000000000000000000001000001
1000000000000000000000000000001000001
1000000000000000000000000000001000001
1000000000000000000000000000001000001
1000000000000000000000000000001000001
1000000000000000000000000000001000001
1000000000000000000000000000001000001
1000000000000000000000000000001000001
1000000000000000000000000000001000001
1111111111111111111111111111111111111