11111111111111111111111111111111111111
10000000000000000000000000010000000001
10000000000000000000000000010000000001
10000000000000000000200000010000000001
10000000000000000000000000010000000001
10000000000000000000000000011000000001
10000000000000000000000000001100000001
10000000000100000000000000000100000001
10000000000100000000000000000000000001
10000000000100000000000000000000000001
10000000111100000000000000000000000001
10000000000000000000000001000000000001
10000000000000000000000001100000000001
10000000000000000000000000110000000001
10000000000000000000000000011000000001
10000000000000000000000000001100000001
10000000000000011000000000000100000001
10000000000000001100000000000000000001
10000000000000000110000000000000000001
10000000000000000011000000000000000001
10000000000000000001100000000000000001
10000002000000000000110000000000000001
10000000000000000000111000000002000001
10000000000000000000111100000000000001
11111111111111111111111111111111111111